0,0,0,0,0,0,0,0,0,0,0,0,0,0,0,0,0
0,2,2,2,2,2,2,2,0,2,2,2,2,2,2,2,0
0,2,0,0,2,0,0,2,0,2,0,0,2,0,0,2,0
0,2,0,0,2,0,0,2,0,2,0,0,2,0,0,2,0
0,2,2,2,2,2,2,2,2,2,2,2,2,2,2,2,0
0,2,0,0,2,0,2,0,0,0,2,0,2,0,0,2,0
0,2,2,2,2,0,2,2,0,2,2,0,2,2,2,2,0
0,0,0,0,2,0,0,2,0,2,0,0,2,0,0,0,0
0,0,0,0,2,0,2,2,2,2,2,0,2,0,0,0,0
0,0,0,0,2,0,2,0,5,0,2,0,2,0,0,0,0
3,4,4,4,2,2,2,0,5,0,2,2,2,4,4,4,7
0,0,0,0,2,0,2,0,0,0,2,0,2,0,0,0,0
0,0,0,0,6,0,2,2,2,2,2,0,2,0,0,0,0
0,0,0,0,2,0,0,2,0,2,0,0,2,0,0,0,0
0,2,2,2,2,2,2,2,0,2,2,2,2,2,2,2,0
0,2,0,0,2,0,0,2,0,2,0,0,2,0,0,2,0
0,2,2,0,2,2,2,2,0,2,2,2,2,0,2,2,0
0,0,2,0,2,0,2,0,0,0,2,0,2,0,2,0,0
0,2,2,2,2,0,2,2,0,2,2,0,2,2,2,2,0
0,2,0,0,0,0,0,2,0,2,0,0,0,0,0,2,0
0,2,2,2,2,2,2,2,2,2,2,2,2,2,2,2,0
0,0,0,0,0,0,0,0,0,0,0,0,0,0,0,0,0
