0,0,0,0,0,0,0,0,0,0,0,0,0,0,0,0,0
0,2,2,2,2,2,2,2,0,2,2,2,2,2,2,2,0
0,2,0,0,2,0,0,2,0,2,0,0,2,0,0,2,0
0,2,0,0,2,0,0,2,0,2,0,0,2,0,0,2,0
0,2,2,2,2,2,2,2,2,2,2,2,2,2,2,2,0
0,2,0,0,2,0,2,0,0,0,2,0,2,0,0,2,0
0,2,2,2,2,0,2,2,0,2,2,2,2,2,2,2,0
0,0,0,0,2,0,2,2,2,2,2,0,2,0,0,0,0
0,0,0,0,2,0,0,0,0,0,2,0,2,0,0,0,0
3,4,4,4,2,0,0,0,0,0
